****************
*              *
*      *****   *
*     *        *
*     *  *******
*     *        *
*   *****      *
*   *   *****  *
*   *   *      *
*   *   *  *****
*       *      *
*       *      *
*       *      *
* *******      *
*              *
****************